15 15
###############
#          E  #
#             #
#             #
#             #
#             #
#             #
#             #
#             #
#             #
#             #
#       B   W #
#      ########
# P  T       ##
###############